year,month,day,hour,BANC Demand (MWh),CISO Demand (MWh),IID Demand (MWh),LDWP Demand (MWh),TIDC Demand (MWh),Total CAL Demand (MWh)
2024,4,20,12,1988,24818,483,2424,334,30047
2024,4,20,1,1873,24573,437,2351,318,29552
2024,4,20,2,1736,23950,393,2228,296,28603
2024,4,20,3,1605,22971,353,2106,274,27309
2024,4,20,4,1512,21588,318,2257,257,25932
2024,4,20,5,1430,20935,293,2140,246,25044
2024,4,20,6,1372,20022,286,2062,236,23978
2024,4,20,7,1339,19363,269,2013,231,23215
2024,4,20,8,1335,19077,274,1999,234,22919
2024,4,20,9,1357,18836,267,1857,237,22554
2024,4,20,10,1388,19174,274,1832,241,22909
2024,4,20,11,1440,19794,272,2130,241,23877
2024,4,20,24,1495,20212,300,2248,240,24495
2024,4,20,13,1499,20972,311,2349,237,25368
2024,4,20,14,1508,20782,345,2366,233,25234
2024,4,20,15,1510,19861,380,2232,232,24215
2024,4,20,16,1534,18686,419,2056,239,22934
2024,4,20,17,1561,17366,455,2026,248,21656
2024,4,20,18,1633,17020,495,2072,260,21480
2024,4,20,19,1721,16720,526,2137,273,21377
2024,4,20,20,1835,17196,554,2260,288,22133
2024,4,20,21,1919,18037,559,2316,303,23134
2024,4,20,22,1958,19410,534,2195,312,24409
2024,4,20,23,1939,21687,510,2302,310,26748
2024,4,21,12,1915,23426,472,2333,304,28450
2024,4,21,1,1817,23774,438,2284,291,28604
2024,4,21,2,1701,23417,398,2326,274,28116
2024,4,21,3,1578,22292,359,2321,257,26807
2024,4,21,4,1504,21260,330,2117,244,25455
2024,4,21,5,1418,20468,310,2055,232,24483
2024,4,21,6,1359,19509,282,2060,223,23433
2024,4,21,7,1329,18931,273,2024,220,22777
2024,4,21,8,1314,18462,266,1997,220,22259
2024,4,21,9,1330,18294,268,1949,220,22061
2024,4,21,10,1356,18503,257,1737,221,22074
2024,4,21,11,1375,18611,278,1938,220,22422
2024,4,21,24,1425,18848,297,2141,218,22929
2024,4,21,13,1451,18983,323,2390,218,23365
2024,4,21,14,1477,19260,366,2383,218,23704
2024,4,21,15,1505,18787,401,2415,221,23329
2024,4,21,16,1548,18005,448,2442,230,22673
2024,4,21,17,1619,17563,496,2504,244,22426
2024,4,21,18,1706,17216,539,2593,260,22314
2024,4,21,19,1832,16711,572,2677,280,22072
2024,4,21,20,1975,17565,590,2418,300,22848
2024,4,21,21,2120,19312,596,2581,322,24931
2024,4,21,22,2202,21723,572,2408,336,27241
2024,4,21,23,2182,23576,528,2463,340,29089
2024,4,22,12,2169,24882,499,2452,343,30345
2024,4,22,1,2041,25080,458,2342,326,30247
2024,4,22,2,1851,24381,410,2383,301,29326
2024,4,22,3,1680,23056,364,2224,278,27602
2024,4,22,4,1559,21602,337,2170,260,25928
2024,4,22,5,1457,20613,316,2061,250,24697
2024,4,22,6,1399,19816,295,2009,243,23762
2024,4,22,7,1363,19226,290,1982,239,23100
2024,4,22,8,1398,19059,282,1911,245,22895
2024,4,22,9,1458,19347,299,1838,260,23202
2024,4,22,10,1565,20464,308,1983,277,24597
2024,4,22,11,1659,21766,342,2374,295,26436
2024,4,22,24,1694,22972,372,2789,300,28127
2024,4,22,13,1721,23351,404,2878,304,28658
2024,4,22,14,1771,23074,432,2885,308,28470
2024,4,22,15,1828,23855,473,2867,319,29342
2024,4,22,16,1893,23732,512,2775,333,29245
2024,4,22,17,1991,23256,562,2757,347,28913
2024,4,22,18,2092,23541,586,2781,366,29366
2024,4,22,19,2206,23410,631,2847,380,29474
2024,4,22,20,2333,22991,639,2704,394,29061
2024,4,22,21,2395,23615,645,2492,407,29554
2024,4,22,22,2362,24540,616,2476,413,30407
2024,4,22,23,2262,25718,578,2499,401,31458
2024,4,23,12,2165,26524,546,2488,389,32112
2024,4,23,1,1996,26625,496,2383,363,31863
2024,4,23,2,1788,25706,437,2241,330,30502
2024,4,23,3,1607,23858,383,2092,302,28242
2024,4,23,4,1517,22215,347,2223,282,26584
2024,4,23,5,1427,21465,322,2134,268,25616
2024,4,23,6,1373,20523,300,2039,258,24493
2024,4,23,7,1354,19952,285,2004,257,23852
2024,4,23,8,1377,19686,285,1929,259,23536
2024,4,23,9,1452,19766,300,1844,274,23636
2024,4,23,10,1556,20830,319,1980,292,24977
2024,4,23,11,1655,22262,325,2350,306,26898
2024,4,23,24,1682,23516,362,2699,302,28561
2024,4,23,13,1686,24049,377,2809,297,29218
2024,4,23,14,1706,23426,392,2838,295,28657
2024,4,23,15,1703,23302,426,2847,293,28571
2024,4,23,16,1719,23479,460,2856,298,28812
2024,4,23,17,1693,22488,493,2782,306,27762
2024,4,23,18,1723,22408,538,2531,308,27508
2024,4,23,19,1731,21621,560,2488,312,26712
2024,4,23,20,1758,21944,590,2528,322,27142
2024,4,23,21,1777,21984,570,2467,334,27132
2024,4,23,22,1781,22585,528,2336,344,27574
2024,4,23,23,1823,23341,496,2404,347,28411
2024,4,24,12,1857,24820,471,2455,349,29952
2024,4,24,1,1776,25244,436,2351,334,30141
2024,4,24,2,1647,24744,386,2203,311,29291
2024,4,24,3,1525,23258,345,2067,290,27485
2024,4,24,4,1464,21673,320,2204,276,25937
2024,4,24,5,1404,21021,290,2095,266,25076
2024,4,24,6,1358,20122,274,2038,259,24051
2024,4,24,7,1351,19609,270,2003,258,23491
2024,4,24,8,1379,19350,279,1949,261,23218
2024,4,24,9,1463,19583,284,1855,274,23459
2024,4,24,10,1580,20724,300,1960,294,24858
2024,4,24,11,1692,22120,324,2262,307,26705
2024,4,24,24,1724,23189,332,2380,309,27934
2024,4,24,13,1774,23734,345,2449,308,28610
2024,4,24,14,1739,23583,365,2683,312,28682
2024,4,24,15,1687,23009,386,2699,308,28089
2024,4,24,16,1666,23298,416,2673,308,28361
2024,4,24,17,1666,22539,443,2648,303,27599
2024,4,24,18,1647,22176,481,2659,304,27267
2024,4,24,19,1677,22233,506,2686,307,27409
2024,4,24,20,1715,22072,518,2751,305,27361
2024,4,24,21,1761,22300,505,2482,310,27358
2024,4,24,22,1783,23120,471,2296,318,27988
2024,4,24,23,1814,23607,446,2417,325,28609
2024,4,25,12,1853,25019,425,2468,331,30096
2024,4,25,1,1790,25559,399,2360,321,30429
2024,4,25,2,1651,25151,363,2282,301,29748
2024,4,25,3,1532,23533,324,2088,282,27759
2024,4,25,4,1465,22100,320,2084,272,26241
2024,4,25,5,1405,21217,290,2032,262,25206
2024,4,25,6,1367,20355,274,2039,255,24290
2024,4,25,7,1338,20109,270,1997,254,23968
2024,4,25,8,1377,19942,279,2021,259,23878
2024,4,25,9,1455,19846,284,1856,273,23714
2024,4,25,10,1579,20969,300,1976,294,25118
2024,4,25,11,1665,22640,324,2312,307,27248
2024,4,25,24,1706,23792,332,2728,307,28865
2024,4,25,13,1676,23832,345,2784,295,28932
2024,4,25,14,1675,23556,365,3040,286,28922
2024,4,25,15,1674,22410,386,3023,287,27780
2024,4,25,16,1680,22029,416,3001,297,27423
2024,4,25,17,1680,21943,443,2988,311,27365
2024,4,25,18,1673,22032,481,2911,313,27410
2024,4,25,19,1699,22174,502,2971,314,27660
2024,4,25,20,1734,22213,511,2885,311,27654
2024,4,25,21,1773,22002,505,2612,317,27209
2024,4,25,22,1788,22844,471,2349,318,27770
2024,4,25,23,1818,23728,446,2425,325,28742
2024,4,26,12,1838,25023,425,2453,329,30068
2024,4,26,1,1765,25463,399,2364,318,30309
2024,4,26,2,1637,25015,363,2198,301,29514
2024,4,26,3,1526,23519,324,2107,282,27758
2024,4,26,4,1498,22082,278,1948,269,26075
2024,4,26,5,1436,21468,269,1999,258,25430
2024,4,26,6,1397,20526,256,1967,249,24395
2024,4,26,7,1378,19955,249,1937,248,23767
2024,4,26,8,1404,19737,264,1956,257,23618
2024,4,26,9,1498,20107,270,2017,271,24163
2024,4,26,10,1605,21131,291,1988,289,25304
2024,4,26,11,1686,22416,308,2338,306,27054
2024,4,26,24,1706,23561,302,2464,305,28338
2024,4,26,13,1742,23661,326,2653,296,28678
2024,4,26,14,1704,23083,318,2636,303,28044
2024,4,26,15,1688,22030,338,2655,295,27006
2024,4,26,16,1664,21969,346,2696,288,26963
2024,4,26,17,1679,21733,355,2691,288,26746
2024,4,26,18,1701,21495,368,2444,287,26295
2024,4,26,19,1736,21458,381,2465,294,26334
2024,4,26,20,1743,20878,387,2515,296,25819
2024,4,26,21,1798,21174,375,2469,306,26122
2024,4,26,22,1778,22409,375,2293,303,27158
2024,4,26,23,1763,22698,375,2348,305,27489
2024,4,27,12,1805,23783,367,2407,311,28673
2024,4,27,1,1758,24367,348,2335,301,29109
2024,4,27,2,1659,24141,321,2232,287,28640
2024,4,27,3,1552,22966,300,2122,271,27211
2024,4,27,4,1492,21740,278,2255,257,26022
2024,4,27,5,1425,21022,263,2128,245,25083
2024,4,27,6,1373,20415,249,2049,239,24325
2024,4,27,7,1363,19802,246,2002,235,23648
2024,4,27,8,1364,19475,246,1988,236,23309
2024,4,27,9,1405,19415,250,1910,238,23218
2024,4,27,10,1435,19628,251,1795,242,23351
2024,4,27,11,1476,20066,263,2012,242,24059
2024,4,27,24,1521,20521,260,2056,239,24597
2024,4,27,13,1513,20547,281,2073,235,24649
2024,4,27,14,1502,19565,288,2058,226,23639
2024,4,27,15,1480,19288,303,2055,223,23349
2024,4,27,16,1545,18493,322,2048,225,22633
2024,4,27,17,1475,18192,349,2248,228,22492
2024,4,27,18,1494,17556,374,2272,233,21929
2024,4,27,19,1569,17304,404,2329,241,21847
2024,4,27,20,1649,17150,426,2347,255,21827
2024,4,27,21,1666,17051,441,2347,268,21773
2024,4,27,22,1685,18938,435,2243,282,23583
2024,4,27,23,1731,20679,421,2218,287,25336
2024,4,28,12,1772,22395,393,2410,291,27261
2024,4,28,1,1711,23106,373,2272,283,27745
2024,4,28,2,1628,22892,344,2258,268,27390
2024,4,28,3,1526,21811,313,2031,253,25934
2024,4,28,4,1465,20981,-31,2052,241,25017
2024,4,28,5,1396,20455,-35,2048,231,24390
2024,4,28,6,1347,20050,-35,1969,226,23839
2024,4,28,7,1329,19523,-36,1926,223,23242
2024,4,28,8,1332,19410,-36,1888,222,23091
2024,4,28,9,1344,19247,-35,1916,224,22973
2024,4,28,10,1361,19171,-22,1762,224,22756
2024,4,28,11,1404,19250,0,2209,222,23085
2024,4,28,24,1464,19212,2,2348,219,23245
2024,4,28,13,1474,18949,4,2353,216,22996
2024,4,28,14,1487,18026,8,2363,212,22096
2024,4,28,15,1491,17233,11,2345,214,21294
2024,4,28,16,1508,16379,11,2370,219,20487
2024,4,28,17,1520,16453,13,2409,226,20621
2024,4,28,18,1554,15936,18,2476,234,20218
2024,4,28,19,1682,15503,23,2290,246,19744
2024,4,28,20,1721,15937,24,2262,263,20207
2024,4,28,21,1804,16912,30,2393,281,21420
2024,4,28,22,1843,19433,9,2323,295,23903
2024,4,28,23,1869,21303,-16,2309,299,26211
2024,4,29,12,1895,23058,-19,2378,306,28054
2024,4,29,1,1819,23752,-17,2294,298,28551
2024,4,29,2,1673,23243,-18,2315,280,27862
2024,4,29,3,1537,21828,-20,2065,262,26012
2024,4,29,4,1455,20578,314,2084,250,24681
2024,4,29,5,1395,19891,290,1961,242,23779
2024,4,29,6,1354,19243,278,1889,236,23000
2024,4,29,7,1338,18769,269,1852,237,22465
2024,4,29,8,1369,18735,269,1882,242,22497
2024,4,29,9,1444,18927,284,1902,257,22814
2024,4,29,10,1556,20365,300,1949,276,24446
2024,4,29,11,1649,21605,326,2342,292,26214
2024,4,29,24,1678,22594,337,2650,290,27549
2024,4,29,13,1668,23171,368,2700,286,28193
2024,4,29,14,1667,22198,388,2711,282,27246
2024,4,29,15,1651,21651,431,2737,279,26749
2024,4,29,16,1659,21259,457,2760,282,26417
2024,4,29,17,1668,20621,500,2797,286,25872
2024,4,29,18,1684,20379,527,2851,292,25733
2024,4,29,19,1730,20096,561,2925,293,25605
2024,4,29,20,1794,20375,579,2936,306,25990
2024,4,29,21,1874,21329,578,2884,316,26981
2024,4,29,22,1900,23080,562,2586,326,28454
2024,4,29,23,1909,24356,539,2575,332,29711
2024,4,30,12,1935,25639,508,2546,336,30964
2024,4,30,1,1833,26135,473,2433,323,31197
2024,4,30,2,1696,25470,420,2256,305,30147
2024,4,30,3,1559,23669,363,2118,288,27997
2024,4,30,4,1492,22338,338,2225,274,26667
2024,4,30,5,1423,21400,311,2109,261,25504
2024,4,30,6,1382,20630,289,2021,252,24574
2024,4,30,7,1366,20131,284,1978,251,24010
2024,4,30,8,1402,19575,278,1702,256,23213
2024,4,30,9,1484,19915,294,1733,270,23696
2024,4,30,10,1597,21151,311,1937,289,25285
2024,4,30,11,1689,22497,338,2337,300,27161
2024,4,30,24,1694,23582,355,2635,294,28560
2024,4,30,13,1672,24185,382,2695,286,29220
2024,4,30,14,1662,23419,398,2955,280,28714
2024,4,30,15,1656,22424,439,2998,280,27797
2024,4,30,16,1730,21785,469,3029,280,27293
2024,4,30,17,1674,21599,514,3086,285,27158
2024,4,30,18,1700,21533,546,3135,292,27206
2024,4,30,19,1737,20993,582,3226,296,26834
2024,4,30,20,1807,21521,594,3002,305,27229
2024,4,30,21,1867,22169,601,2893,317,27847
2024,4,30,22,1905,23974,572,2538,329,29318
2024,4,30,23,1915,24456,536,2516,332,29755
2024,5,1,12,1938,25727,511,2508,336,31020
2024,5,1,1,1854,26307,467,2393,326,31347
2024,5,1,2,1713,25564,419,2204,305,30205
2024,5,1,3,1562,24035,377,2061,284,28319
2024,5,1,4,1504,22738,338,2204,271,27055
2024,5,1,5,1437,21925,317,2108,262,26049
2024,5,1,6,1386,21106,298,2024,255,25069
2024,5,1,7,1377,20711,287,1984,254,24613
2024,5,1,8,1404,20409,287,1809,258,24167
2024,5,1,9,1483,20711,297,1751,271,24513
2024,5,1,10,1586,21817,310,1909,288,25910
2024,5,1,11,1695,23294,325,2319,298,27931
2024,5,1,24,1703,24272,347,2457,293,29072
2024,5,1,13,1679,24313,361,2715,285,29353
2024,5,1,14,1663,23264,385,2732,280,28324
2024,5,1,15,1645,22655,417,2753,276,27746
2024,5,1,16,1640,22169,454,2765,277,27305
2024,5,1,17,1658,21814,497,2820,284,27073
2024,5,1,18,1683,21841,538,2869,293,27224
2024,5,1,19,1731,22061,565,2939,300,27596
2024,5,1,20,1785,21642,583,2792,310,27112
2024,5,1,21,1858,22632,601,2843,322,28256
2024,5,1,22,1903,23885,574,2525,334,29221
2024,5,1,23,1909,24618,546,2486,338,29897
2024,5,2,12,1948,25842,513,2504,342,31149
2024,5,2,1,1867,26546,472,2389,332,31606
2024,5,2,2,1725,25885,419,2209,312,30550
2024,5,2,3,1594,24251,384,2040,292,28561
2024,5,2,4,1522,22911,341,2151,277,27202
2024,5,2,5,1457,22325,302,2033,263,26380
2024,5,2,6,1403,21120,294,2024,257,25098
2024,5,2,7,1396,20467,284,1985,256,24388
2024,5,2,8,1414,20242,286,1813,260,24015
2024,5,2,9,1487,20524,297,1754,274,24336
2024,5,2,10,1586,21694,315,1964,292,25851
2024,5,2,11,1681,23253,333,2367,307,27941
2024,5,2,24,1703,23790,359,2519,304,28675
2024,5,2,13,1722,24338,382,2585,301,29328
2024,5,2,14,1721,24491,407,2575,300,29494
2024,5,2,15,1723,23680,434,2531,298,28666
2024,5,2,16,1755,23450,477,2503,303,28488
2024,5,2,17,1793,22399,514,2542,312,27560
2024,5,2,18,1867,22837,546,2591,323,28164
2024,5,2,19,1935,22521,576,2663,332,28027
2024,5,2,20,2013,22778,595,2760,343,28489
2024,5,2,21,2082,22620,598,2804,354,28458
2024,5,2,22,2111,23985,582,2499,364,29541
2024,5,2,23,2077,24794,550,2444,361,30226
2024,5,3,12,2081,25761,520,2479,361,31202
2024,5,3,1,1992,26112,478,2371,348,31301
2024,5,3,2,1818,25653,427,2479,323,30700
2024,5,3,3,1658,24226,380,2367,300,28931
2024,5,3,4,1559,22896,349,2225,282,27311
2024,5,3,5,1469,22267,317,2117,270,26440
2024,5,3,6,1412,21574,296,2026,262,25570
2024,5,3,7,1386,21068,289,1993,262,24998
2024,5,3,8,1399,20778,289,2004,264,24734
2024,5,3,9,1460,20912,297,2082,275,25026
2024,5,3,10,1552,22068,310,2277,290,26497
2024,5,3,11,1648,23137,333,2400,303,27821
2024,5,3,24,1679,24237,360,2556,301,29133
2024,5,3,13,1688,24720,379,2630,296,29713
2024,5,3,14,1693,24548,409,2627,293,29570
2024,5,3,15,1715,23957,437,2580,291,28980
2024,5,3,16,1742,23185,477,2578,300,28282
2024,5,3,17,1799,22938,509,2595,308,28149
2024,5,3,18,1855,22793,538,2623,315,28124
2024,5,3,19,2003,21488,577,2658,324,27050
2024,5,3,20,2003,21270,593,2685,337,26888
2024,5,3,21,2050,21969,595,2708,345,27667
2024,5,3,22,2036,23190,570,2379,354,28529
2024,5,3,23,1971,24107,536,2388,349,29351
2024,5,4,12,1950,25260,507,2422,340,30479
2024,5,4,1,1854,25920,461,2313,324,30872
2024,5,4,2,1719,25285,418,2206,303,29931
2024,5,4,3,1589,24015,371,2020,284,28279
2024,5,4,4,1522,22751,340,1883,265,26761
2024,5,4,5,1438,21922,319,1773,254,25706
2024,5,4,6,1387,21070,292,1703,242,24694
2024,5,4,7,1354,20396,286,1656,238,23930
2024,5,4,8,1350,19882,276,1949,236,23693
2024,5,4,9,1373,19762,285,1982,240,23642
2024,5,4,10,1403,19889,280,1922,241,23735
2024,5,4,11,1487,20363,291,2146,246,24533
2024,5,4,24,1604,21962,320,2279,256,26421
2024,5,4,13,1678,23136,344,2382,266,27806
2024,5,4,14,1757,23476,365,2441,273,28312
2024,5,4,15,1797,24108,405,2426,274,29010
2024,5,4,16,1797,24503,441,2345,273,29359
2024,5,4,17,1800,24783,471,2351,273,29678
2024,5,4,18,1766,23141,515,2343,277,28042
2024,5,4,19,1625,22028,551,2319,273,26796
2024,5,4,20,1600,20770,542,2306,259,25477
2024,5,4,21,1598,20790,494,2070,246,25198
2024,5,4,22,1622,21023,443,2065,256,25409
2024,5,4,23,1659,21547,419,2153,258,26036
2024,5,5,12,1742,22636,399,2218,268,27263
2024,5,5,1,1704,23455,367,2140,264,27930
2024,5,5,2,1635,23135,339,2135,258,27502
2024,5,5,3,1559,22326,310,2109,245,26549
2024,5,5,4,1489,21392,294,1953,234,25362
2024,5,5,5,1430,20705,270,1980,226,24611
2024,5,5,6,1393,20425,258,1985,221,24282
2024,5,5,7,1378,19952,249,1930,219,23728
2024,5,5,8,1389,19741,247,1910,220,23507
2024,5,5,9,1409,19729,251,1823,223,23435
2024,5,5,10,1436,19803,241,1631,225,23336
2024,5,5,11,1471,20408,252,1904,225,24260
2024,5,5,24,1496,20098,266,1897,223,23980
2024,5,5,13,1573,19452,276,1878,212,23391
2024,5,5,14,1472,18118,275,2169,211,22245
2024,5,5,15,1460,18227,273,1882,203,22045
2024,5,5,16,1457,17617,272,1870,202,21418
2024,5,5,17,1460,17247,294,1876,205,21082
2024,5,5,18,1432,17074,306,1902,202,20916
2024,5,5,19,1458,15746,319,1983,207,19713
2024,5,5,20,1492,14794,336,2099,220,18941
2024,5,5,21,1563,15556,348,2236,234,19937
2024,5,5,22,1598,18110,347,2206,252,22513
2024,5,5,23,1674,20328,340,2233,268,24843
2024,5,6,12,1747,21986,343,2226,286,26588
2024,5,6,1,1707,23318,329,2175,279,27808
2024,5,6,2,1592,23126,299,2186,266,27469
2024,5,6,3,1482,21950,274,2190,252,26148
2024,5,6,4,1425,20714,255,1900,242,24536
2024,5,6,5,1378,20389,242,1869,236,24114
2024,5,6,6,1347,20098,235,1857,233,23770
2024,5,6,7,1352,19746,238,1856,234,23426
2024,5,6,8,1384,19301,242,1858,242,23027
2024,5,6,9,1484,19535,252,1791,258,23320
2024,5,6,10,1625,20746,271,1930,277,24849
2024,5,6,11,1704,22249,292,2248,289,26782
2024,5,6,24,1692,23395,293,2420,281,28081
2024,5,6,13,1674,23478,301,2429,273,28155
2024,5,6,14,1631,21686,311,2411,264,26303
2024,5,6,15,1593,21370,312,2395,260,25930
2024,5,6,16,1597,20621,339,2397,256,25210
2024,5,6,17,1590,19851,363,2426,259,24489
2024,5,6,18,1578,19175,387,2446,263,23849
2024,5,6,19,1606,19106,420,2497,266,23895
2024,5,6,20,1648,18721,444,2595,277,23685
2024,5,6,21,1710,19236,457,2681,289,24373
2024,5,6,22,1710,21151,463,2547,303,26174
2024,5,6,23,1793,23029,446,2497,310,28075
2024,5,7,12,1855,24713,429,2521,320,29838
2024,5,7,1,1785,25513,395,2435,312,30440
2024,5,7,2,1649,24995,359,2299,293,29595
2024,5,7,3,1532,23507,326,2115,276,27756
2024,5,7,4,1468,22002,295,1967,263,25995
2024,5,7,5,1407,21440,272,1860,252,25231
2024,5,7,6,1360,20644,266,1786,245,24301
2024,5,7,7,1351,20244,254,1733,245,23827
2024,5,7,8,1391,20333,261,1747,250,23982
2024,5,7,9,1470,20391,271,1856,263,24251
2024,5,7,10,1584,21187,289,2023,281,25364
2024,5,7,11,1678,22608,310,2372,289,27257
2024,5,7,24,1650,23856,322,2408,281,28517
2024,5,7,13,1644,23805,334,2437,272,28492
2024,5,7,14,1601,22812,360,2448,263,27484
2024,5,7,15,1585,22111,376,2444,260,26776
2024,5,7,16,1666,21702,416,2472,260,26516
2024,5,7,17,1604,20519,453,2492,264,25332
2024,5,7,18,1613,19322,493,2536,268,24232
2024,5,7,19,1636,18906,535,2616,273,23966
2024,5,7,20,1700,18990,565,2696,285,24236
2024,5,7,21,1751,20050,578,2755,296,25430
2024,5,7,22,1795,21818,546,2596,307,27062
2024,5,7,23,1840,23810,518,2500,316,28984
2024,5,8,12,1886,25474,483,2533,324,30700
2024,5,8,1,1811,26030,441,2422,316,31020
2024,5,8,2,1685,25463,393,2292,300,30133
2024,5,8,3,1556,23883,354,2110,281,28184
2024,5,8,4,1492,22445,316,1972,267,26492
2024,5,8,5,1433,21757,291,1829,255,25565
2024,5,8,6,1379,21071,279,1742,248,24719
2024,5,8,7,1362,20456,266,1698,246,24028
2024,5,8,8,1395,20017,271,1690,248,23621
2024,5,8,9,1464,20241,281,1789,261,24036
2024,5,8,10,1574,21133,307,1973,277,25264
2024,5,8,11,1652,22486,315,2287,284,27024
2024,5,8,24,1669,23378,338,2439,278,28102
2024,5,8,13,1651,23883,347,2457,268,28606
2024,5,8,14,1621,22762,376,2451,264,27474
2024,5,8,15,1619,22337,397,2452,262,27067
2024,5,8,16,1625,21629,423,2474,264,26415
2024,5,8,17,1629,20830,456,2526,267,25708
2024,5,8,18,1666,20252,481,2585,275,25259
2024,5,8,19,1704,19414,513,2648,280,24559
2024,5,8,20,1769,19420,532,2752,293,24766
2024,5,8,21,1861,20717,539,2700,308,26125
2024,5,8,22,1881,23234,526,2521,321,28483
2024,5,8,23,1900,24598,507,2551,328,29884
2024,5,9,12,1931,26050,476,2578,332,31367
2024,5,9,1,1856,26738,439,2475,321,31829
2024,5,9,2,1715,25969,392,2292,303,30671
2024,5,9,3,1581,24365,357,2104,284,28691
2024,5,9,4,1515,22691,320,1953,270,26749
2024,5,9,5,1449,22025,293,1821,260,25848
2024,5,9,6,1399,20918,275,1753,252,24597
2024,5,9,7,1378,20509,273,1706,251,24117
2024,5,9,8,1405,20355,269,1721,254,24004
2024,5,9,9,1478,20497,286,1814,270,24345
2024,5,9,10,1562,21395,294,1990,288,25529
2024,5,9,11,1666,22609,313,2230,300,27118
2024,5,9,24,1699,23785,350,2454,297,28585
2024,5,9,13,1735,23890,364,2579,296,28864
2024,5,9,14,1736,23886,388,2562,295,28867
2024,5,9,15,1778,23745,407,2494,300,28724
2024,5,9,16,1826,22531,446,2484,310,27597
2024,5,9,17,1900,22229,466,2543,321,27459
2024,5,9,18,1986,21582,503,2631,334,27036
2024,5,9,19,2071,21644,543,2714,347,27319
2024,5,9,20,2191,21636,552,2736,363,27478
2024,5,9,21,2258,23095,563,2716,376,29008
2024,5,9,22,2278,25104,548,2538,387,30855
2024,5,9,23,2258,26024,523,2536,389,31730
2024,5,10,12,2232,26998,493,2568,385,32676
2024,5,10,1,2114,27354,455,2457,368,32748
2024,5,10,2,1923,26541,414,2278,340,31496
2024,5,10,3,1738,24898,357,2105,313,29411
2024,5,10,4,1637,23339,321,1963,293,27553
2024,5,10,5,1534,22337,311,1844,279,26305
2024,5,10,6,1465,21323,286,1768,270,25112
2024,5,10,7,1418,20753,284,1725,266,24446
2024,5,10,8,1438,20346,273,1735,265,24057
2024,5,10,9,1493,20683,289,1851,276,24592
2024,5,10,10,1581,21607,302,2001,293,25784
2024,5,10,11,1690,22672,333,2400,307,27402
2024,5,10,24,1740,23497,357,2484,310,28388
2024,5,10,13,1813,23751,384,2514,312,28774
2024,5,10,14,1800,23517,414,2534,316,28581
2024,5,10,15,1934,23391,451,2539,323,28638
2024,5,10,16,2030,22874,486,2552,336,28278
2024,5,10,17,2179,22498,529,2576,351,28133
2024,5,10,18,2284,21720,566,2633,366,27569
2024,5,10,19,2430,22051,596,2718,382,28177
2024,5,10,20,2550,22839,611,2774,400,29174
2024,5,10,21,2620,24123,590,2798,412,30543
2024,5,10,22,2590,25238,570,2619,420,31437
2024,5,10,23,2523,26533,523,2484,414,32477
2024,5,11,12,2425,27411,499,2502,400,33237
2024,5,11,1,2284,27254,470,2428,380,32816
2024,5,11,2,2063,26606,427,2284,351,31731
2024,5,11,3,1872,25126,396,2303,320,30017
2024,5,11,4,1741,23713,346,2281,296,28377
2024,5,11,5,1605,22696,326,2157,279,27063
2024,5,11,6,1517,21552,310,2058,266,25703
2024,5,11,7,1458,20612,296,1999,259,24624
2024,5,11,8,1431,20180,283,1986,255,24135
2024,5,11,9,1429,20197,287,2001,256,24170
2024,5,11,10,1435,20180,285,1860,256,24016
2024,5,11,11,1515,20371,313,2089,258,24546
2024,5,11,24,1603,20984,331,2140,261,25319
2024,5,11,13,1671,21595,363,2167,266,26062
2024,5,11,14,1750,20283,409,2377,276,25095
2024,5,11,15,1843,20278,448,2423,287,25279
2024,5,11,16,1947,20239,479,2440,304,25409
2024,5,11,17,2103,19623,511,2450,324,25011
2024,5,11,18,2280,19539,540,2307,346,25012
2024,5,11,19,2452,19446,571,2382,370,25221
2024,5,11,20,2593,19921,589,2494,390,25987
2024,5,11,21,2691,21732,603,2583,406,28015
2024,5,11,22,2695,23496,587,2543,414,29735
2024,5,11,23,2605,25131,550,2340,404,31030
2024,5,12,12,2466,26272,522,2342,388,31990
2024,5,12,1,2306,26323,484,2269,365,31747
2024,5,12,2,2090,25650,441,2251,336,30768
2024,5,12,3,1884,24272,398,2232,308,29094
2024,5,12,4,1749,22795,362,2189,287,27382
2024,5,12,5,1615,22003,338,2088,268,26312
2024,5,12,6,1524,20932,312,2005,253,25026
2024,5,12,7,1453,20174,294,1949,246,24116
2024,5,12,8,1418,19788,284,1923,243,23656
2024,5,12,9,1413,19475,284,1850,240,23262
2024,5,12,10,1397,19577,283,1723,237,23217
2024,5,12,11,1451,19344,298,1970,238,23301
2024,5,12,24,1514,19982,345,2162,241,24244
2024,5,12,13,1584,21168,389,2156,250,25547
2024,5,12,14,1647,20877,437,2130,261,25352
2024,5,12,15,1704,20328,477,2138,278,24925
2024,5,12,16,1813,19525,521,2168,299,24326
2024,5,12,17,1936,18878,570,2231,322,23937
2024,5,12,18,2113,18376,604,2342,344,23779
2024,5,12,19,2296,17698,651,2470,365,23480
2024,5,12,20,2461,18535,672,2499,382,24549
2024,5,12,21,2580,20435,673,2614,396,26698
2024,5,12,22,2596,23051,653,2475,404,29179
2024,5,12,23,2500,24773,607,2397,401,30678
2024,5,13,12,2386,25977,569,2419,391,31742
2024,5,13,1,2226,26310,523,2342,370,31771
2024,5,13,2,1986,25639,472,2226,336,30659
2024,5,13,3,1783,24065,418,2316,305,28887
2024,5,13,4,1630,22388,384,2098,281,26781
2024,5,13,5,1528,21521,350,1981,267,25647
2024,5,13,6,1458,20684,331,1925,256,24654
2024,5,13,7,1422,20148,314,1881,252,24017
2024,5,13,8,1432,19911,317,1920,254,23834
2024,5,13,9,1486,20296,327,1953,266,24328
2024,5,13,10,1583,21139,347,1994,285,25348
2024,5,13,11,1673,22535,392,2362,302,27264
2024,5,13,24,1722,23872,431,2531,307,28863
2024,5,13,13,1752,24545,468,2595,314,29674
2024,5,13,14,1787,24493,511,2619,321,29731
2024,5,13,15,1852,23976,560,2554,327,29269
2024,5,13,16,1934,23117,610,2486,341,28488
2024,5,13,17,2062,22621,657,2511,355,28206
2024,5,13,18,2194,22005,701,2546,374,27820
2024,5,13,19,2345,21986,729,2640,395,28095
2024,5,13,20,2499,23120,720,2709,415,29463
2024,5,13,21,2601,24063,698,2606,426,30394
2024,5,13,22,2567,25169,680,2512,430,31358
2024,5,13,23,2460,26462,619,2476,421,32438
2024,5,14,12,2343,27521,575,2541,406,33386
2024,5,14,1,2168,27952,529,2415,385,33449
2024,5,14,2,1952,27072,467,2259,354,32104
2024,5,14,3,1744,25306,424,2071,324,29869
2024,5,14,4,1642,23743,382,1926,303,27996
2024,5,14,5,1539,22579,339,1918,288,26663
2024,5,14,6,1462,21546,326,1945,276,25555
2024,5,14,7,1431,20924,313,1897,275,24840
2024,5,14,8,1449,20780,312,1929,278,24748
2024,5,14,9,1495,20805,319,1935,287,24841
2024,5,14,10,1592,21816,341,1986,301,26036
2024,5,14,11,1684,23144,371,2186,315,27700
2024,5,14,24,1730,24505,402,2511,315,29463
2024,5,14,13,1759,25443,427,2583,317,30529
2024,5,14,14,1818,25216,462,2550,320,30366
2024,5,14,15,1895,24253,517,2485,330,29480
2024,5,14,16,1989,22675,564,2420,349,27997
2024,5,14,17,2130,22640,604,2448,370,28192
2024,5,14,18,2291,21838,650,2523,391,27693
2024,5,14,19,2483,21980,687,2625,417,28192
2024,5,14,20,2632,22858,694,2735,441,29360
2024,5,14,21,2747,24615,687,2577,451,31077
2024,5,14,22,2720,25754,657,2491,443,32065
2024,5,14,23,2618,27400,601,2457,434,33510
2024,5,15,12,2498,27959,567,2504,428,33956
2024,5,15,1,2308,28174,507,2412,406,33807
2024,5,15,2,2060,27379,460,2253,370,32522
2024,5,15,3,1848,25522,414,2169,336,30289
2024,5,15,4,1734,23838,361,2234,312,28479
2024,5,15,5,1639,22947,337,2119,298,27340
2024,5,15,6,1546,21948,315,2030,286,26125
2024,5,15,7,1512,21390,305,1999,282,25488
2024,5,15,8,1518,21217,298,2029,285,25347
2024,5,15,9,1568,21281,309,2138,295,25591
2024,5,15,10,1662,22147,321,1979,312,26421
2024,5,15,11,1748,23414,355,2192,326,28035
2024,5,15,24,1820,24573,390,2592,328,29703
2024,5,15,13,1832,25332,410,2699,333,30606
2024,5,15,14,1921,25422,439,2741,341,30864
2024,5,15,15,2014,25786,489,2717,351,31357
2024,5,15,16,2138,24844,511,2684,368,30545
2024,5,15,17,2309,24130,539,2653,392,30023
2024,5,15,18,2496,24427,559,2623,418,30523
2024,5,15,19,2706,24717,593,2634,442,31092
2024,5,15,20,2895,24820,609,2685,462,31471
2024,5,15,21,2977,25648,618,2455,474,32172
2024,5,15,22,2923,27118,605,2386,479,33511
2024,5,15,23,2776,27568,565,2470,469,33848
2024,5,16,12,2617,28282,540,2554,451,34444
2024,5,16,1,2391,28433,493,2452,424,34193
2024,5,16,2,2129,27673,445,2295,385,32927
2024,5,16,3,1910,25921,398,2143,350,30722
2024,5,16,4,1773,24324,364,2256,322,29039
2024,5,16,5,1656,23266,329,2207,303,27761
2024,5,16,6,1575,22177,312,2152,289,26505
2024,5,16,7,1537,21680,298,2114,285,25914
2024,5,16,8,1536,21343,300,2144,286,25609
2024,5,16,9,1602,21404,314,2202,295,25817
2024,5,16,10,1673,22348,330,2159,310,26820
2024,5,16,11,1765,23833,361,2404,324,28687
2024,5,16,24,1800,24900,393,1887,325,29305
2024,5,16,13,1804,26162,420,1979,328,30693
2024,5,16,14,1852,26282,458,2081,337,31010
2024,5,16,15,1880,26577,506,2114,348,31425
2024,5,16,16,1933,26127,542,2147,364,31113
2024,5,16,17,2014,25785,603,2226,388,31016
2024,5,16,18,2109,25570,652,2356,412,31099
2024,5,16,19,2236,25079,707,2425,437,30884
2024,5,16,20,2362,24916,718,2507,462,30965
2024,5,16,21,2436,24868,718,2544,476,31042
2024,5,16,22,2408,25918,676,2665,480,32147
2024,5,16,23,2321,26583,624,2601,466,32595
2024,5,17,12,2248,27647,593,2695,445,33628
2024,5,17,1,2117,28173,541,2588,421,33840
2024,5,17,2,1931,27240,479,2469,381,32500
2024,5,17,3,1764,25496,416,2329,344,30349
2024,5,17,4,1648,23937,381,2382,317,28665
2024,5,17,5,1574,22875,359,2274,298,27380
2024,5,17,6,1502,22063,325,2101,286,26277
2024,5,17,7,1482,21508,312,2054,283,25639
2024,5,17,8,1497,21560,313,2078,283,25731
2024,5,17,9,1557,21659,311,2173,289,25989
2024,5,17,10,1638,22625,333,2268,302,27166
2024,5,17,11,1791,23812,368,2468,315,28754
2024,5,17,24,1752,26014,398,2578,313,31055
2024,5,17,13,1752,26835,435,2691,311,32024
2024,5,17,14,2058,26744,474,2750,314,32340
2024,5,17,15,1807,26442,518,2762,320,31849
2024,5,17,16,1868,26903,561,2721,333,32386
2024,5,17,17,1961,25189,619,2672,347,30788
2024,5,17,18,2085,24319,673,2624,365,30066
2024,5,17,19,2232,23097,698,2558,384,28969
2024,5,17,20,2379,22941,712,2572,406,29010
2024,5,17,21,2561,23161,694,2673,419,29508
2024,5,17,22,2498,24686,662,2714,424,30984
2024,5,17,23,2434,26116,603,2564,417,32134
2024,5,18,12,2335,27060,564,2675,402,33036
2024,5,18,1,2202,27602,514,2605,385,33308
2024,5,18,2,2007,27111,466,2438,355,32377
2024,5,18,3,1836,25675,419,2326,326,30582
2024,5,18,4,1728,23928,376,2453,303,28788
2024,5,18,5,1614,23181,341,2333,286,27755
2024,5,18,6,1542,22533,327,2244,271,26917
2024,5,18,7,1499,21782,316,2167,265,26029
2024,5,18,8,1477,21430,307,2143,261,25618
2024,5,18,9,1486,21168,304,2088,259,25305
2024,5,18,10,1471,21214,303,1999,264,25251
2024,5,18,11,1519,21177,332,2100,268,25396
2024,5,18,24,1561,21947,371,2313,269,26461
2024,5,18,13,1589,21500,412,2535,272,26308
2024,5,18,14,1619,21581,450,2594,276,26520
2024,5,18,15,1667,21155,497,2581,282,26182
2024,5,18,16,1707,21029,531,2487,297,26051
2024,5,18,17,1779,20487,586,2355,314,25521
2024,5,18,18,1862,20078,618,2316,334,25208
2024,5,18,19,1995,19083,660,2372,355,24465
2024,5,18,20,2122,18997,661,2266,376,24422
2024,5,18,21,2218,20101,659,2421,394,25793
2024,5,18,22,2215,22390,603,2403,401,28012
2024,5,18,23,2148,24454,557,2442,389,29990
2024,5,19,12,2077,25123,519,2516,367,30602
2024,5,19,1,1969,25648,473,2535,345,30970
2024,5,19,2,1824,25163,424,2406,318,30135
2024,5,19,3,1702,23953,392,2283,291,28621
2024,5,19,4,1622,22572,369,2378,272,27213
2024,5,19,5,1534,22336,338,2214,257,26679
2024,5,19,6,1491,21508,311,2072,248,25630
2024,5,19,7,1457,20721,293,837,242,23550
2024,5,19,8,,,,,,23550
2024,5,19,9,,,,,,25305
2024,5,19,10,,,,,,25251
2024,5,19,11,,,,,,25396
2024,5,19,24,,,,,,26461
2024,5,19,13,,,,,,26308
2024,5,19,14,,,,,,26520
2024,5,19,15,,,,,,26182
2024,5,19,16,,,,,,26051
2024,5,19,17,,,,,,25521
2024,5,19,18,,,,,,25208
2024,5,19,19,,,,,,24465
2024,5,19,20,,,,,,24422
2024,5,19,21,,,,,,25793
2024,5,19,22,,,,,,28012
2024,5,19,23,,,,,,29990
2024,5,20,12,,,,,,30602
2024,5,20,1,,,,,,30970
2024,5,20,2,,,,,,30135
2024,5,20,3,,,,,,28621
2024,5,20,4,1605,22450,353,2019,263,26690
2024,5,20,5,1520,21600,324,1946,251,25641
2024,5,20,6,1471,20804,302,1885,245,24707
2024,5,20,7,1462,20454,291,1939,244,24390
2024,5,20,8,1490,20215,285,138,248,22376
